40 10 2
0000000000000000000000000000000000000000
0------0---------00000000000000000000000
0------0------------00000000000000000000
00000--0----000--------00000000000000000
0------0----000000--------00000000000000
0------0----000000000--------00000000000
0--000000000000000000000--------00000000
0-----------000000000000000------------0
0-----------000000000000000000---------0
0000000000000000000000000000000000000000
0000000000000000000000000000000000000000
0------0-----0---00000000000000000000000
0------0-----0------00000000000000000000
00000--00000000--------00000000000000000
0------0----000000--------00000000000000
0------0----000000000--------00000000000
0--00000----000000000000--------00000000
0-----------000000000000000------------0
0-----------000000000000000000---------0
0000000000000000000000000000000000000000